# domain<TAB>label<TAB>hint
# hint: pictorial|interview|general
www.vogue.co.kr	Vogue Korea	pictorial
www.elle.co.kr	ELLE Korea	pictorial
www.wkorea.com	W Korea	pictorial
www.harpersbazaar.co.kr	Harper’s BAZAAR Korea	pictorial
www.gqkorea.co.kr	GQ Korea	interview
www.marieclairekorea.com	Marie Claire Korea	pictorial
www.cosmopolitan.co.kr	Cosmopolitan Korea	pictorial
www.esquirekorea.co.kr	Esquire Korea	interview
www.allurekorea.com	Allure Korea	pictorial
www.singleskorea.com	Singles	pictorial
www.arenakorea.com	Arena	pictorial
kstar.kbs.co.kr	KBS연예	general
news.kbs.co.kr	KBS뉴스	general
news.sbs.co.kr	SBS뉴스	general
imnews.imbc.com	MBC뉴스	general
news.jtbc.co.kr	JTBC뉴스	general
about.netflix.com	Netflix(공식)	general
www.disneypluskr.com	Disney+(KR)	general
www.disneyplus.com	Disney+	general
